8 8 8 8 8 8 8 8 8 8 8 8 8 8 8 8 8 8 8 8
3 2 2 2 3 3 3 3 3 3 2 2 3 2 3 2 2 2 2 4
2 2 2 2 2 3 3 3 3 2 3 2 3 2 3 3 3 2 3 4
2 2 3 3 2 3 3 3 2 2 2 3 2 3 3 3 2 3 2 5
3 2 2 2 3 3 3 3 3 3 2 2 3 2 3 2 2 2 2 5
2 2 2 2 2 3 3 3 3 2 3 2 3 2 3 3 3 2 3 5
2 2 3 3 2 3 3 3 2 2 2 3 2 3 3 3 2 3 2 4
3 2 2 2 3 3 3 3 3 3 2 2 3 2 3 2 2 2 2 5
2 2 2 2 2 3 3 3 3 2 3 2 3 2 3 3 3 2 3 5
2 2 3 3 2 3 3 3 2 2 2 3 2 3 3 3 2 3 2 4
3 2 2 2 3 3 3 3 3 3 2 2 3 2 3 2 2 2 2 4
2 2 2 2 2 3 3 3 3 2 3 2 3 2 3 3 3 2 3 4
2 2 3 3 2 3 3 3 2 2 2 3 2 3 3 3 2 3 2 5
3 2 2 2 3 3 3 3 3 3 2 2 3 2 3 2 2 2 2 4
3 2 2 2 3 3 3 3 3 3 2 2 3 2 3 2 2 2 2 5