04010101010101010101010101010101010101010101010101010101010101010101010101010104
01010101010101010101010101010101010101010101010101010101010101010101010101010101
01010101010101010101010101010101010101010101010101010104010101040101010101010101
01010101010401040101010401010101010101010104010101010101010101010101040101010101
01010101010101010101010101010101040101010101010101010101010101010101010101010101
01010101010101010101010101010101010101010101010101010101010101010101010101010101
0101010101090101013c010101010101010101010101010101010101010101010101010101010101
01010101010101010101010101010101010101010101010101010101010109010101010401010101
01010101010101010901010101010101010101010101010101010101010101010101010101010101
01010101010101010109011001010101040101010401010101010109010101010101010101010101
0101040101010101010109010101010101010104010101010101092d010101010101010401010101
01010101010101010101010101010101010101010101010109010101010101010101010101010101
01010101010101010101010101090101010101260101010901011001010101010101010101010101
01010101010101010101010101010109010401010109010101010101010101010101010401010101
01010401010101010101010101010101011d01010101010101010101010101010101010101010101
01010101010101010101010101010101010904090101010101010101010101010101010401010101
01010101010101010101010101010101010901010101010101010101010101010101010101010101
01040101010101010101010101010401040101040109010101010101013401010101010101010101
01010101010101013a01010101010101090101010101010101010101010101010101010101010101
0101010101010101010b01010101090101010101010401010104010b010101010101010101010101
01040101010101010101010101090101010101010101010901010101010101010101010101010101
01010101010101010101010901010101010101010101010101010101010101010101010101010101
01040101010101010101010101010104040101010101010101010901010101010101010401010101
01040101010101010109010101010101010101010101010101010101010901010101010101010101
01010101010101090901010101010101010101010101010101010101010101010101010101010101
01010101010101010101010101010101010101010101010101010101010101090101040101010101
01010104010101010101010401010101040101010104010101040101010401010101010101010101
01010101010101010101010101010101010101010101010101010101010101010101010101010101
01010101010101010101010101010101010101010101010101010101010101010101010101010101
04010101010101010101010101010101010101010101010101010101010101010101010101010104
