00000005000000050000000500000005000000010000000100000006000000010000000100000008000000010000000100000001000000080000000100000001000000010000000100000001000000010000000100000001000000010000000c00000001000000010000000100000001000000010000000100000001000000010000000100000001000000010000000100000001000000010000000100000013
000000080000000100000001000000010000000c000000010000000c00000001000000010000000100000001000000010000000100000001000000010000000100000001000000010000000100000001000000010000000100000001000000010000000100000001000000010000000c000000010000000100000001000000010000000100000001000000010000000100000001000000010000000100000001
00000001000000010000000100000001000000010000000100000001000000010000000c0000000100000001000000010000000100000001000000010000000100000001000000010000000c000000080000000100000001000000010000000100000001000000010000000100000001000000010000000100000001000000010000000100000001000000010000000100000001000000010000000100000001
00000008000000010000000100000001000000010000000100000001000000010000000100000001000000010000000100000001000000010000000100000008000000010000000100000001000000010000000100000001000000080000000100000001000000010000000100000001000000010000000100000001000000010000000100000001000000010000000100000001000000010000000100000001
0000000800000001000000010000000100000001000000010000000100000001000000010000000100000001000000010000000100000001000000010000000100000001000000010000000100000001000000010000000100000001000000010000000100000001000000010000000c000000010000000100000001000000010000000100000001000000010000000100000001000000010000000100000008
00000008000000040000000100000001000000010000000100000001000000010000000100000001000000010000000100000001000000010000000100000001000000010000000100000001000000010000000100000001000000010000000100000001000000010000000100000001000000010000000100000001000000010000000100000001000000010000000100000001000000010000000100000001
00000001000000010000000100000001000000010000000100000001000000010000000100000008000000010000000100000001000000010000000100000001000000010000000100000001000000010000000100000001000000010000000100000001000000010000000100000001000000010000000100000001000000010000000100000001000000010000000100000001000000010000000100000008
00000008000000010000000100000001000000010000000100000001000000010000000100000001000000010000000c0000000100000001000000010000000100000001000000010000000100000001000000010000000100000001000000010000000c000000010000000100000001000000010000000100000001000000010000000100000001000000010000000100000001000000010000000100000004
00000008000000010000000100000001000000010000000800000001000000010000000100000001000000010000000100000001000000010000000100000001000000010000000800000001000000010000000100000001000000010000000100000001000000010000000100000001000000010000000100000001000000010000000100000001000000010000000100000001000000010000000100000008
00000008000000010000000100000001000000010000000100000001000000010000000100000001000000010000000100000001000000010000000100000001000000010000000100000001000000010000000100000001000000010000000100000001000000010000000100000001000000010000000100000001000000010000000100000001000000010000000100000001000000010000000100000001
00000001000000010000000100000001000000010000000100000001000000010000000100000001000000010000000100000001000000010000000100000001000000010000000100000001000000010000000100000001000000010000000c00000001000000010000000100000001000000010000000100000001000000010000000100000001000000010000000100000001000000010000000400000008
00000008000000010000000100000001000000010000000100000001000000010000000100000001000000010000000100000001000000010000000100000001000000010000000100000001000000010000000100000001000000010000000100000001000000010000000100000001000000010000000100000001000000010000000100000001000000010000000100000001000000010000000100000008
00000001000000010000000100000001000000010000000100000001000000010000000100000001000000010000000100000008000000010000000100000001000000010000000100000001000000010000000100000001000000010000000100000001000000010000000100000001000000010000001200000001000000010000000100000001000000010000000100000001000000010000000100000004
00000008000000010000000100000001000000010000000100000001000000010000000100000001000000010000000100000001000000010000000100000001000000010000000100000001000000010000000100000001000000010000000100000001000000010000000100000001000000010000000100000001000000010000001200000001000000010000000100000001000000010000000400000008
00000008000000010000000100000001000000010000000100000001000000010000000100000001000000010000001300000001000000010000000100000001000000010000000100000001000000010000000100000001000000010000000100000001000000010000000100000001000000010000000100000001000000010000000100000001000000010000000100000001000000010000000100000001
00000001000000010000000100000012000000010000000100000001000000010000000100000001000000010000000100000001000000130000000100000001000000010000000100000001000000010000000100000001000000010000000100000001000000010000000100000001000000010000000100000001000000010000000100000001000000010000000100000001000000010000000400000008
00000008000000010000000100000001000000010000000100000001000000010000000100000001000000010000000100000001000000010000000100000001000000010000000100000001000000010000000100000013000000010000000100000012000000010000000100000001000000010000000100000001000000010000000100000001000000010000000100000001000000010000000100000001
00000004000000010000000100000001000000010000000100000001000000010000000100000001000000010000000100000001000000010000000100000001000000010000000100000001000000010000000100000001000000010000000100000001000000010000000100000001000000010000000100000001000000010000000100000001000000010000000100000001000000010000000100000008
00000008000000010000000100000001000000010000000100000001000000010000000100000001000000010000000100000001000000010000000100000001000000010000000100000001000000010000000100000001000000010000000100000001000000010000000100000001000000010000001200000001000000010000000100000001000000010000000100000001000000010000000400000008
00000004000000010000000100000001000000010000000100000001000000010000000100000012000000010000000100000001000000010000000100000001000000010000000100000001000000010000000100000001000000010000000100000001000000010000000100000001000000130000000100000001000000010000000100000001000000010000000100000001000000010000000100000001
00000008000000010000000100000001000000010000001300000001000000010000000100000001000000010000000100000001000000010000000100000012000000010000000100000001000000010000000100000001000000010000000100000001000000010000000100000001000000010000000100000001000000010000000100000001000000010000000100000001000000010000000800000004
00000001000000010000000100000001000000010000000100000001000000010000000100000001000000010000000100000001000000010000000100000001000000010000000100000001000000010000000100000001000000010000000100000001000000010000000100000001000000010000000100000001000000010000000100000001000000010000000100000001000000010000000800000001
00000008000000040000000100000001000000010000001300000001000000010000000100000001000000010000000100000001000000010000000100000001000000010000000100000001000000010000001200000001000000010000000100000001000000010000000100000001000000010000000100000001000000010000000100000001000000010000000100000001000000010000000100000008
00000001000000010000000100000001000000010000000100000001000000010000000100000001000000010000000100000001000000010000000100000001000000010000000100000001000000010000000100000001000000010000000100000001000000010000000100000001000000010000000100000001000000010000000100000001000000010000000100000001000000010000000100000004
00000001000000010000000100000001000000010000000100000001000000130000000100000001000000010000000100000001000000010000000100000001000000010000000100000001000000010000000100000001000000010000000100000001000000010000000100000001000000130000000100000001000000010000000100000001000000010000000100000001000000010000000800000008
00000008000000010000000100000001000000010000000100000001000000010000000100000001000000010000000100000013000000010000000100000001000000010000000100000013000000010000000100000001000000010000001300000001000000010000000100000001000000010000000100000001000000010000000100000001000000010000000100000001000000010000000100000001
00000001000000010000000100000001000000010000000100000001000000010000000100000001000000010000000100000013000000010000000100000001000000010000000100000001000000010000000100000001000000010000000100000001000000010000000100000001000000010000000100000001000000010000000100000001000000010000000100000001000000010000000100000001
00000001000000010000000100000001000000010000000100000001000000010000000100000001000000010000000100000001000000010000000100000001000000010000000100000001000000010000000100000013000000010000000100000001000000010000000100000001000000010000000100000001000000010000000100000001000000010000000100000001000000010000000100000001
00000001000000010000000100000001000000010000000100000001000000010000000100000001000000010000000100000001000000010000000100000001000000010000001300000001000000010000000100000001000000010000001300000001000000010000001300000001000000010000000100000001000000010000000100000012000000010000001200000001000000010000000100000001
00000013000000010000001200000001000000010000001300000001000000130000001200000001000000010000001300000001000000130000001200000001000000010000001200000001000000130000001200000001000000010000001200000001000000010000001200000001000000010000001200000001000000010000000100000001000000010000000100000001000000010000000100000013
