00010005000100050001000500010005000100010000000100000006000000010000000100000008000000010000000100000001000000080000000100000001000000010000000100000001000000010000000100000001000000010000000c00000001000000010000000100000001000000010000000100000001000000010000000100000001000000010000000100000001000000010000000100000013
000000080001000100010001000100010000000c000000010000000c00000001000000010000000100000001000000010000000100000001000000010000000100000001000000010000000100000001000000010000000100000001000000010000000100000001000000010000000c000000010000000100000001000000010000000100000001000000010000000100000001000000010000000100000001
00000001000000010000000100000001000000010000000100000001000000010000000c0000000100000001000000010000000100000001000000010000000100000001000000010000000c000000080000000100000001000000010000000100000001000000010000000100000001000000010000000100000001000000010000000100000001000000010000000100000001000000010000000100000001
0000000c000000010000000100000001000000010000000100000001000000010000000100000001000000010000000100000001000000010000000100000008000000010000000100000001000000010000000100000001000000080000000100000001000000010000000100000001000000010000000100000001000000010000000100000001000000010000000100000001000000010000000100000001
0000000c00000001000000010000000100000001000000010000000100000001000000010000000100000001000000010000000100000001000000010000000100000001000000010000000100000001000000010000000100000001000000010000000100000001000000010000000c000000010000000100000001000000010000000100000001000000010000000100000001000000010000000100000008
0000000c000000050000000100000001000000010000000100000001000000010000000100000001000000010000000100000001000000010000000100000001000000010000000100000001000000010000000100000001000000010000000100000001000000010000000100000001000000010000000100000001000000010000000100000001000000010000000100000001000000010000000100000001
0000000c000000050000000100000001000000010000000100000001000000010000000100000008000000010000000100000001000000010000000100000001000000010000000100000001000000010000000100000001000000010000000100000001000000010000000100000001000000010000000100000001000000010000000100000001000000010000000100000001000000010000000100000008
0000000c000000050000000100000001000000010000000100000001000000010000000100000001000000010000000c0000000100000001000000010000000100000001000000010000000100000001000000010000000100000001000000010000000c000000010000000100000001000000010000000100000001000000010000000100000001000000010000000100000001000000010000000100000004
00000008000000050000000100000001000000010000000800000001000000010000000100000001000000010000000100000001000000010000000100000001000000010000000800000001000000010000000100000001000000010000000100000001000000010000000100000001000000010000000100000001000000010000000100000001000000010000000100000001000000010000000100000008
0000000c000000010000000500000001000000010000000100000001000000010000000100000001000000010000000100000001000000010000000100000001000000010000000100000001000000010000000100000001000000010000000100000001000000010000000100000001000000010000000100000001000000010000000100000001000000010000000100000001000000010000000100000001
0000000c000000010000000100000001000000010000000100000001000000010000000100000001000000010000000100000001000100010000000100000001000000010001000100000001000000010000000100000001000000010000000c00000001000000010000000100000001000000010000000100000001000000010000000100000001000000010000000100000001000000010000000400000008
00000008000000010000000100010001000000010000000100000001000000010000000100000001000000010000000100000001000000010000000100000001000000010001000100000001000000010000000100000001000000010000000100000001000000010000000100000001000000010000000100000001000000010000000100000001000000010000000100000001000000010000000100000008
000000010001000c0000000100000001000000010000000100000001000000010000000100000001000000010000000100000008000000010000000100000001000100010001000100010001000000010000000100000001000000010000000100000001000000010000000100000001000000010000001200000001000000010000000100000001000000010000000100000001000000010000000100000004
00000008000000010000000100000001000000010000000900000009000000090000000100000001000000010000000100000001000000010000000100000001000000010001000100000001000000010000000100000001000000010000000100000001000000010000000100000001000000010000000100000001000000010000001200000001000000010000000100000001000000010000000400000008
000000080001000c0000000100000001000000010000000900000001000000010000000900000001000000010000001300000001000000010000000100000001000000010000000100000001000000010000000100000001000000010000000100000001000000010000000100000001000000010000000100000001000000010000000100000001000000010000000100000001000000010000000100000001
000000010000000c0000000100010012000000010000000900000001000000090000000100000001000000010000000100000001000000130000000100000001000000010000000100000001000000010000000100000001000000010000000100000001000000010000000100000001000000010000000100000001000000010000000100000001000000010000000100000001000000010000000400000008
00000008000000010000000100000001000000010000000900000001000000010000000900000001000000010000000100000001000000010000000100000001000000010000000100000001000000010000000100000013000000010000000100000012000000010000000100000001000000010000000100000001000000010000000100000001000000010000000100000001000000010000000100000001
000000040000000c0000000100000001000000010000000900000009000000090000000100000001000000010000000100000001000000010000000100000001000000010000000100000001000000010000000100000001000000010000000100000001000000010000000100000001000000010000000100000001000000010000000100000001000000010000000100000001000000010000000100000008
000000080000000c0000000100000001000000010000000100000001000000010000000100000001000000010000000100000001000000010000000100000001000000010000000100000001000000010000000100000001000000010000000100000001000000010000000100000001000000010000001200000001000000010000000100000001000000010000000100000001000000010000000400000008
0000000c000000010000000100000001000000010000000100000001000000010000000100010012000000010000000100000001000100010000000100000001000000010000000100000001000000010000000100000001000000010000000100000001000000010000000100000001000000130000000100000001000000010000000100000001000000010000000100000001000000010000000100000001
0000000c000000010000000100000001000000010001001300000001000000010000000100000001000000010000000100000001000000010000000100000012000000010000000100000001000000010000000100000001000000010000000100000001000000010000000100000001000000010000000100000001000000010000000100000001000000010000000100000001000000010000000800000004
000000010000000c0000000c00000001000000010000000100000001000000010000000100000001000000010000000100000001000000010000000100000001000000010000000100000001000000010000000100000001000000010000000100000001000000010000000100000001000000010000000100000001000000010000000100000001000000010000000100000001000000010000000800000001
00000008000000040000000100000001000000010000001300000001000000010000000100000001000000010000000100000001000000010000000100000001000000010000000100000001000000010000001200000001000000010000000100000001000000010000000100000001000000010000000100000001000000010000000100000001000000010000000100000001000000010000000100000008
00000001000000010000000100000001000000010000000100000001000000010000000100000001000000010000000100000001000000010000000100000001000000010000000100000001000000010000000100000001000000010000000100000001000000010000000100000001000000010000000100000001000000010000000100000001000000010000000100000001000000010000000100000004
00000001000000010000000100000001000000010000000100000001000000130000000100000001000000010000000100000001000000010000000100000001000000010000000100000001000000010000000100000001000000010000000100000001000000010000000100000001000000130000000100000001000000010000000100000001000000010000000100000001000000010000000800000008
00000008000000010000000100000001000000010000000100000001000000010000000100000001000000010000000100000013000000010000000100000001000000010000000100000013000000010000000100000001000000010000001300000001000000010000000100000001000000010000000100000001000000010000000100000001000000010000000100000001000000010000000100000001
00000001000000010000000100000001000000010000000100000001000000010000000100000001000000010000000100000013000000010000000100000001000000010000000100000001000000010000000100000001000000010000000100000001000000010000000100000001000000010000000100000001000000010000000100000001000000010000000100000001000000010000000100000001
00000001000000010000000100000001000000010000000100000001000000010000000100000001000000010000000100000001000000010000000100000001000000010000000100000001000000010000000100000013000000010000000100000001000000010000000100000001000000010000000100000001000000010000000100000001000000010000000100000001000000010000000100000001
00000001000000010000000100000001000000010000000100000001000000010000000100000001000000010000000100000001000000010000000100000001000000010000001300000001000000010000000100000001000000010000001300000001000000010000001300000001000000010000000100000001000000010000000100000012000000010000001200000001000000010000000100000001
00000013000000010000001200000001000000010000001300000001000000130000001200000001000000010000001300000001000000130000001200000001000000010000001200000001000000130000001200000001000000010000001200000001000000010000001200000001000000010000001200000001000000010000000100000001000000010000000100000001000000010000000100000013
