00130001000100010001000100060001000100080001000100010008000100010001000100010001000100010001000c0001000100010001000100010001000100010001000100010001000100010013
0001000100010001000c0001000c00010001000100010001000100010001000100010001000100010001000100010001000100010001000c000100010001000100010001000100010001000100010001
00010001000100010001000100010001000c000100010001000100010001000100010001000c000800010001000100010001000100010001000100010001000100010001000100010001000100010001
0001000100010001000100010001000100010001000100010001000100010008000100010001000100010001000800010001000100010001000100010001000100010001000100010001000100010001
000100010001000100010001000100010001000100010001000100010001000100010001000100010001000100010001000100010001000c000100010001000100010001000100010001000100010001
0001000100010001000100010001000100010001000100010001000100010001000100010001000100010001000100010001000100010001000100010001000100010001000100010001000100010001
0001000100010001000100010001000100010008000100010001000100010001000100010001000100010001000100010001000100010001000100010001000100010001000100010001000100010001
00010001000100010001000100010001000100010001000c000100010001000100010001000100010001000100010001000c000100010001000100010001000100010001000100010001000100010001
0001000100010001000100080001000100010001000100010001000100010001000100080001000100010001000100010001000100010001000100010001000100010001000100010001000100010001
0001000100010001000100010001000100010001000100010001000100010001000100010001000100010001000100010001000100010001000100010001000100010001000100010001000100010001
00010001000100010001000100010001000100010001000100010001000100010001000100010001000100010001000c0001000100010001000100010001000100010001000100010001000100010001
0001000100010001000100010001000100010001000100010001000100010001000100010001000100010001000100010001000100010001000100010001000100010001000100010001000100010001
0001000100010001000100010001000100010001000100010008000100010001000100010001000100010001000100010001000100010001000100120001000100010001000100010001000100010001
0001000100010001000100010001000100010001000100010001000100010001000100010001000100010001000100010001000100010001000100010001000100120001000100010001000100010001
0001000100010001000100010001000100010001000100130001000100010001000100010001000100010001000100010001000100010001000100010001000100010001000100010001000100010001
0001000100010012000100010001000100010001000100010001001300010001000100010001000100010001000100010001000100010001000100010001000100010001000100010001000100010001
0001000100010001000100010001000100010001000100010001000100010001000100010001000100010013000100010012000100010001000100010001000100010001000100010001000100010001
0001000100010001000100010001000100010001000100010001000100010001000100010001000100010001000100010001000100010001000100010001000100010001000100010001000100010001
0001000100010001000100010001000100010001000100010001000100010001000100010001000100010001000100010001000100010001000100120001000100010001000100010001000100010001
0001000100010001000100010001000100010012000100010001000100010001000100010001000100010001000100010001000100010001001300010001000100010001000100010001000100010001
0001000100010001000100130001000100010001000100010001000100010012000100010001000100010001000100010001000100010001000100010001000100010001000100010001000100010001
0001000100010001000100010001000100010001000100010001000100010001000100010001000100010001000100010001000100010001000100010001000100010001000100010001000100010001
0001000100010001000100130001000100010001000100010001000100010001000100010001000100120001000100010001000100010001000100010001000100010001000100010001000100010001
0001000100010001000100010001000100010001000100010001000100010001000100010001000100010001000100010001000100010001000100010001000100010001000100010001000100010001
0001000100010001000100010001001300010001000100010001000100010001000100010001000100010001000100010001000100010001001300010001000100010001000100010001000100010001
0001000100010001000100010001000100010001000100010013000100010001000100010013000100010001000100130001000100010001000100010001000100010001000100010001000100010001
0001000100010001000100010001000100010001000100010013000100010001000100010001000100010001000100010001000100010001000100010001000100010001000100010001000100010001
0001000100010001000100010001000100010001000100010001000100010001000100010001000100010013000100010001000100010001000100010001000100010001000100010001000100010001
0001000100010001000100010001000100010001000100010001000100010001000100130001000100010001000100130001000100130001000100010001000100010012000100120001000100010001
0013000100120001000100130001001300120001000100130001001300120001000100120001001300120001000100120001000100120001000100120001000100010001000100010001000100010013
